0
44444422222244422222222224444444444444444444422222222222444444444444444444444444444444444444444444444444444444444444444444444
00000442222440042222222240000000000000000004442222222224422224222222222244444422000000000000000000000000000000000000000000000
00000044224400004222222400000000000000000000444222222244222222422222244444222220000000200000000000000000000000000000000000000
00000044240000004422224000000000000000000000044422222442222222242222444442222200000002420000000000000000000000000000000000000
00000444400000000442244000000000000000000000004442224422222222242224444422222000000002222000000000000000000000000000000000000
00004440000000000042240000000000000000000000000442244222002222224444422222200000000002244200000000000000000000000000000000000
00044000000000000044000000000000000000000000000042442200000022220044222222000000000022444420000000000000000000000000000000000
00040000000000000440004440000000000000000000000044400000000002240002222220000000002224444442000000000000000000000000000000000
00000000000000000000044224440000000000000000000444000000000000044000222200000000022244444444200000000000000000000000000000000
00000000000000000000422222244000000000000000004400000000000000042400022000000002222244444444420000000000000000000000000000000
00000000000000000004422222240000000000000000004000000000000000442240000000000022224444444444442000000000000000000000000000000
00000000000000000000442222400000000000000000000000000000000004422224000000000222444444444444444200000000000000000000000000000
00000400000000000000044224000000000000000000000000000000000044222222400000002224444444444444444422000000000000000000000000000
00000440000000000000004240002200000000000000000000000000000004222222440000022244444444444444444422200000000000000000000000000
00000044400000000000004400022220000000000000000000000000000000442244400000222244444444444444444442220000000000000000000000000
00000004440000000000224000222222000000000000400000000000004400044400000002222444444444444444444444222000000000000000000000000
00000004244220000002222004422222200000000000440000000000000440000000000022244444444444444444444444422000000000000000000000000
00000044224422200222222444442222220000000000044400000000000422400000000022244444444444444444444444220000000000000000000000000
00000444222442222222224222444442222200000000004444000000004422440000000022244444444444444444444444222000000000000000000000000
00004442222244222222224222244444222220000000000442400000044222240000000022244444444444444444444444222000000000000000000000000
00044422222224422222242222224444422222000000000442244000042222224000000222444444444444444444444444442200000000000000000000000
00444222222222442222422222222224444442200000004422224400422222222400022222444444444444444444444444442220000000000000000000000
44442222222222244444444444444444444444444444444222222444222222222244444444444444444444444444444444444444444444444444444444444